// Initial position, dirty probability, random seed, map
5 6 0.01 1
O O O O O O O O O O
O - - - - - - - - O
O - - - - - - - - O
O - - - - - - - - O
O - - - - - X - - O
O - - - - - - - - O
O - - - - - - - - O
O - - - - - - - - O
O - - - - - - - - O
O O O O O O O O O O
